30
30
PPPPPPPPPPPPPPPPPPPPPPPPPPPPPP
PPPPPPPPPPPPPPPPPPPPPPPPPPPPPP
PPPPPPPPPPPPPPPPPPPPPPPPPPPPPP
PPPTSTTTTTTTTTAABSSSSBBBBSSPPP
PPPTTTTTTTTTTTTTTTTTTTTTTTTPPP
PPPTTTTTTTTTTTTTTTTTTTTTTTTPPP
PPPTTTTTTTTTTSSTTTTTTTTSSSSPPP
PPPTTTSTSTSTSSSSTTTTTTTSSSSPPP
PPPTTSSSSSSSSTTSSTTTTSSSSTTPPP
PPPPPSSPPPPPPPPSSPPPPTSSSSTPPP
PPPSSSBBSSBSAASBBSBSSSSTSSTPPP
PPPTBBBBSSSSSSSSSSSSTTTSSSTPPP
PPPTTBBBBBSBSSBSSBSSSSTTTSTPPP
PPPTTTTTTTTTTTTTTTTSSTSSSSTPPP
PPPTTTTTTTTTTTTTTTTTBBBTTTTPPP
PPPTTTTTTTTTTTTTTTTTBBBBBBBPPP
PPPTTTTTTTTTTTTTTTTTBSSSBSMPPP
PPPSAASSSBSSSSTSTTTTTTTTTTMPPP
PPPBBBSSBAABSBSSTTTPPPPPPPPPPP
PPPBBBBBBBBAABSSBTTTTSSSSSMPPP
PPPBBBBBBBBBBSSTTTTTTSSTTSMPPP
PPPBBBBBBBBBBBSSBTTTTTSSTSMPPP
PPPBBBBBBBBBBSSBBTTTTTSSTSMPPP
PPPBBBBBBBBBBSSBBTTTTTTTTTTPPP
PPPTTTTTTTTTTTTTTTTTTTTTTTMPPP
PPPTTTTTTTTTTTTTTTTTTTTTTTTPPP
PPPTTTTTTTTTTTTTTTTTTTTTTTTPPP
PPPPPPPPPPPPPPPPPPPPPPPPPPPPPP
PPPPPPPPPPPPPPPPPPPPPPPPPPPPPP
PPPPPPPPPPPPPPPPPPPPPPPPPPPPPP
